NO ./textures/wall.xpm
SO ./textures/wall.xpm
WE ./textures/wall.xpm
EA ./textures/wall.xpm
DO ./textures/wall.xpm

F 220,100,0
C 225,30,0

                           1111111111111
                           1000000000001
     11111       111111111110000000000011111
     10001       100000000010000000000010001
     10001       1000000000C00000000000C0001
     10001       100000000010000000000010001
     11C11111111 100011111110000000000011111
     1000000000111000111   1000000000001
     1000000000100000001   111111C111111
     1000000000C00000001       10001
111111000000000100000001       10001
100011000000000111111111       10001
1000111111C11111          111111000111
1000111110001             100000000001
11C1111110001             100111000111
1000100010001             1001 10001
1000C00010001             1111 10001
1000100010001                  10001
1000111111C11111               11C11             111111111111
1000110000000001          111110000011111        100000000001
1000110000000001          100000000000001        100000000001
1000110000000001          10000000000000111111111100000000001
1000010000000001          10000000000000100000000100000000001
10000C0000000001          10000000000000C00000000C00000000001
1000010000000001          10000000000000100000000100000000001
1000110000000001          10000000000000111000111100000000001
1000110000000001          100000000000001 10001  100000000001
1000110000000001          100000000000001 10001  100000000001
1000111111C11111          111110000011111 10001 1111111111111
1000111110001                  11C11      100011001001001001
1000100010001                  10001      1000010000000000001
1000C00010001                 1000001     10000C0000000000001
1000100010001                  10001      1000010000000000001
1000111110001                  10001      111111001001001001
1000111110001111111111111     1000001           11 11 11 11
1000000000000000010000001      10001
10000000000000000C0000001      10001
1000000000000000010000001     1000001
1C11111111111111111111111      10001
1C1                        111111C111111
1C1                        1000100010001
1C1                        1000C000C0001
1C1                        1000100010001
1C1                        1111100011111
1C1                        1000100010001
1C1                        1000C000C0001
1C1                        1000100010001
1C1                        1111100011111
1C1                        1000000000001
1C1                        100000N000001
101                        1000000000001
111                        1111111111111