NO ./textures/wall.xpm
SO ./textures/box.xpm
WE ./textures/ground.xpm
EA ./textures/orb.xpm
DO ./textures/death.xpm

F 255,10,255
C 225,30,255

111111111
100000001
100000001
100000001
1000N1001
100000001
100000001
100000001
111111111