NO ./textures/wall.xpm
SO ./textures/wall.xpm
WE ./textures/wall.xpm
EA ./textures/wall.xpm

F 220,100,0
C 225,30,0

111111111
100000001
100010001
1001N1001
100010001
100000001
111111111